NO ./images/brick_texture.xpm
SO ./images/brick_texture.xpm
WE ./images/brick_texture.xpm
EA ./images/brick_texture.xpm

F 220,220,100
C -153,204,255

11111111
10100001
10100001
1010N001
10000001
10100101
11 11 11