NO ./path_to_the_north_texture
SO ./path_to_the_south_texture
WE ./path_to_the_west_texture
EA ./path_to_the_east_texture

F 220,220,220
C 153,204,255


111111
100001
100101
1000N1
100001
111111