NO ./path_to_the_north_texture
SO ./path_to_the_south_texture
WE ./path_to_the_west_texture
EA ./path_to_the_east_texture

F 220,220,220
C 153,204,255


11111111
10000001
10000001
1000N001
10000001
10100101
11 11 11