NO ./images/north_ko.xpm
SO ./images/south_ko.xpm
WE ./images/west_ko.xpm
EA ./images/east_ko.xpm
CD ./images/closed-door.xpm

F 110,153,15 
C 255,255,255

        1111111111111111111111111
        1000000000000000000000001
        1000000000000001111111111
        1000000000000000000000001
111111111111211111111111111111111
100000001000000000000000000001111
100000002000000W0000111111111
11111111100000000001
10000000000000000000111111111
10000000000000000000000010001
10000000000000000001010020001
11000001110121011111011110101
11110111 1110111 111111110001
11111111 1111111 111111111111